10
20
50000000000000000005
50000000100000000005
50000000000000005555
50005000000000000005
50000000500000000005
50000005000000000005
50000000005000000005
50000050000000000005
50000000000000000005
55555555555555555555